XXXTTTTTTTTTXXX
_______________
_______________
_______________
X_____________X
XX___________XX
XXX_________XXX
XX___________XX
X_____________X
_______________
_______________
_______________
_______________
_______________
_______________